11111111111111111111
1P000C00000C00000001
111CF11F111F1111F0C1
1EC00000C00000000001
11111111111111111111