11111111
1E000C01
100000P1
11111111