111111111111111111111
11P000C00000000000011
111001101110111101111
1E0000000000000000011
111111111111111111111