11111111111111111111
1P000C00000C00000011
111CF11F111F1111F111
10E00000C000000000C1
11111111111111111111