11111111
1P000E01
111CF111
11111111