11111111111111111111
1P000000000000000011
11100110111011110111
1E0000000000000C0001
11111111111111111111