1111111111111111111111
10000C0000000000000111
1000001000000000000011
100000C100000000000001
1000001000000000001111
1000P000000011E0001001
1000000C00000000001001
1111111111111111111111