1111111111111111111111
10000C000000000C000001
1001000000C00000001001
100C11111111111111C001
1001000000C00000001001
1000P000000000E0000001
1000000C0000000C000001
1111111111111111111111