1111111111111111111111
10000C0000000000000001
1000000000000000C00001
1000000000000000000001
1000000000000000000001
1000000000000000000001
1000P000000011E0000001
1000000000000000000001
1111111111111111111111