1111111111111111111111
1000000000000000000111
1000000000000000000001
1000000000000000000011
1000000000000000000001
1000000000000000000001
1000P000C00000E0000001
100000C00000C000000001
1111111111111111111111