11111111111111111111
1P000000000000000101
1C11111111C111110101
10000C00010100000C01
10111011110111110101
1000100000C000000001
101010111011111101C1
10101000001000000001
10101110111011110C01
1000C00010000C000101
10111111101111110101
1000C0001000C0000101
10111110101111110101
100C0010100001000001
11111110111111C111C1
10000C00100001000C01
10111111101101111001
10E000001000C00000C1
11111111111111111111