1111111111111111111111
10000C000000000C000001
1001000000C000000010E1
100C11111111111111C001
1001000000C00000001001
1000P00000000000000001
1000000C0000000C000001
1111111111111111111111