1111111111111111111111
11C1000000000000000111
1100000100000000000011
100000C100000000000001
10E0111000000000001111
1000P11000001100001001
1000100C00000000001001
1111111111111111111111